0 0 0 0 0 0 0 0 0 0 0 0 0 0 0
0 0 4 0 0 0 0 0 0 0 0 0 0 0 0
0 0 1 1 0 0 0 0 0 0 0 0 0 0 0
0 0 1 1 1 0 0 0 0 0 0 0 0 0 0
0 0 0 1 1 1 0 0 0 0 1 1 1 0 0
0 1 1 1 1 1 5 0 0 0 1 1 1 1 0
0 1 0 0 0 0 0 0 0 0 1 0 0 1 0
0 1 1 6 1 1 -1 1 1 1 1 0 0 1 0
0 1 0 0 0 0 5 0 0 1 0 0 0 1 0
0 1 0 0 0 0 0 0 0 1 0 0 0 1 0
0 1 1 1 0 0 2 0 0 1 1 1 1 1 0
0 1 1 1 0 0 0 0 0 0 0 1 1 1 0
0 0 0 4 0 0 0 0 0 0 0 1 1 1 0
0 0 0 0 0 0 0 0 0 0 0 0 0 0 0
0 0 0 0 0 0 0 0 0 0 0 0 0 0 0
4 2 9 3 9 6 9 6 6